..#.................
.B#D................
.#...###############
.#.................#
.#################.#
.#.................#
.#.#################
.#..................
.###########..######
....................